INDIA - DATASET (INITIAL VERSION)

1. General Information:
   - Official Name: Republic of India
   - Capital: New Delhi
   - Area: 3,287,263 sq. km
   - Population: 1.4 billion (approximate)
   - Official Languages: Hindi, English (22 other recognized languages)
   - Currency: Indian Rupee (INR)
   - Time Zone: IST (UTC+5:30)

2. Government & Politics:
   - President: Droupadi Murmu (as of 2024)
   - Prime Minister: Narendra Modi (as of 2024)
   - Government Type: Federal Parliamentary Democratic Republic
   - Legislature: Parliament (Lok Sabha & Rajya Sabha)
   - Independence: August 15, 1947 (from British rule)
   - Constitution Adopted: January 26, 1950

3. Geography:
   - Borders: Pakistan, China, Nepal, Bhutan, Bangladesh, Myanmar
   - Largest State (by area): Rajasthan
   - Smallest State (by area): Goa
   - Largest City: Mumbai
   - Major Rivers: Ganges, Yamuna, Brahmaputra, Godavari

4. Economy & Industry:
   - GDP: Approx. $3.7 trillion (2024 estimate)
   - Major Industries: IT, Agriculture, Manufacturing, Pharmaceuticals, Automobiles
   - Top Exports: Petroleum products, Gems & Jewelry, Pharmaceuticals, Textiles

5. Natural Resources:
   - Coal, Iron Ore, Bauxite, Manganese, Mica, Natural Gas, Petroleum
   - Major Crops: Rice, Wheat, Sugarcane, Cotton, Tea, Spices

6. States & Union Territories:
   - Total States: 28
   - Total Union Territories: 8
   - Example States: Uttar Pradesh, Maharashtra, Tamil Nadu, West Bengal, Karnataka

7. Science & Technology:
   - Space Agency: Indian Space Research Organisation (ISRO)
   - Notable Missions: Chandrayaan (Moon Mission), Mangalyaan (Mars Mission)
   - IT Hub: Bengaluru (Known as the Silicon Valley of India)

8. Culture & Heritage:
   - Major Religions: Hinduism, Islam, Christianity, Sikhism, Buddhism, Jainism
   - Festivals: Diwali, Holi, Eid, Christmas, Navratri
   - UNESCO Heritage Sites: Taj Mahal, Jaipur City, Qutub Minar, Ajanta Caves

This is an initial version of the dataset. More details will be added soon.
